
                           +------+
                           |      |
 +-------------------------+      +-------------------------+
 |                                                          |
 |                                                          |
 |  +---+  +-----------------+  +------------------------+  |
 |  |+--+  |+------+      +--+  +--++------++------+--+  |  |
 |  ||     ||      |      |        ||      ||         |  |  |
 |  ||     ||      |      |        ||      ||         |  |  |
 |  ||     ||      |+-----+        ||      ||      +--+  |  |
 |  |+--+  |+-+  +-+|              ||      |+-+  +-++---+|  |
 |  |+--+  +-+|  |  |              ||      |+-+  +-+|   ||  |
 |  ||       ||  |  |  +--+        ||      ++      ++   ||  |
 |  ||       ++  |+-+  +-+|        ||                   ||  |
 |  ||           ||      ||        ||                   ||  |
 |  ||       ++  ||      ||        ||      ++      ++   ||  |
 |  ||       ||  ||      ||        ||      ||      ||   ||  |
 |  |+-------+|  |+------+|        |+-+  +-++------+++  ||  |
 |  +---------+  +--------+        +--+  +-----------+  ++  |
 |                                                          | 
 |                                                          |
 |  ++  +--+  +-------+  +---+  +---+  +-------------+  ++  |
 |  ||  |+-+  +-++---+|  |+--+  +--+|  |+-----++----+|  ||  |
 |  ||  ||      ||   ||  ||        ||  ||     ||    ||  ||  |
 |  ||  ||      ||   ||  ||        ||  ||     ++    ++  ||  |
 |  ||  ||      ||   ||  ||        ||  ||               ||  |
 |  ||  |+------+|   ||  ||        ||  ||     ++    ++  ||  |
 |  ||  +--------+  ++|  ||        ||  ||  +--++----+|  ||  |
 |  ||              | |  ||        ||  |+--+   +--+  |  ||  |
 |  ||              | |  ||        ||  |    +--+  +-+|  ||  |
 |  ||  +--+  +--+  ++|  |+--+  +--+|  |    |       ||  ||  |
 |  ||  |+-+  +-+|   ||  +---+  +---+  |    |       ||  ||  |
 |  ||  ||      ||   ||                |    +--+  +-+|  ||  |
 |  ||  ||      ||   ||                |+---++-+  +-+|  ||  |
 |  ||  ||      ||   ||                ||   ||      ||  ||  |
 |  ||  |+------++---+|                ||   ++      ||  ||  |
 |  ||  +-------++---+|                ||           ||  ||  |
 |  ||          ||   ||                ||           ||  ||  |
 |  ||          ||   ||                ||   ++      ||  ||  |
 |  ||  ++      ||   ||                ||   ||      ||  ||  |
 |  ||  |+------+|   |+------+  +------+|  +++-+  +-+|  ||  |
 |  ||  +--------+   |       |  |       |  +---+  +--+  ||  |
 |  ||             +-+       |  |       |               ||  |
 |  ||             |        ++  ++      |               ||  |
 |  |+-------------+  +-----+    +---+  +---------------+|  |
 |  +-----------------+              +-------------------+  |
 |                                                          |
 |                       +---+  +---+                       |
 +-----------------------+   +--+   +-----------------------+